#####################
### ## ## ######### #
#E                  #
#### ###### ###### ##
#### ###### #####F ##
####  ##### #########
##   ######   #######
#####################